Maze field

################
#@@   #        #
#@@   #    A   #
#     #        #
# A  ##  ##    #
#    #   #     #
#  A    ##     #
#       #      #
#   A  ##      #
########       #
#              #
#              #
#              #
#          1111#
#          1111#
################
